-#####---
-#   ####
-# @ #  #
-## O  +#
### ###+#
# O #-#+#
# O #-###
#   #----
#####----