########
#      #
#    O #
#  #   #
#  #####
#  #----
#@+#----
####----