-#######--
-#     ###
##O###   #
#   @O O #
# ++# O ##
##++#   #-
-########-