---------
-#######-
-#+ + +#-
-# OOO #-
-#+O@O+#-
-# OOO #-
-#+ + +#-
-#######-
---------