--------------
--####--#####-
-##  #--#   #-
-# O ####O  #-
-#  O++++ O #-
-##    # @ ##-
--##########--
--------------