----------
-########-
-#      #-
-# @    #-
-# O   +#-
-########-
----------